SO src/north.xpm
NO src/north.xpm
WE src/north.xpm
EA src/north.xpm
C 153,204,255           
F 164,169,20



                                                  
                11111111111111111111111111    
                11111111111111111111111111    
                111111111111111111111011111   
                1111   0000010000000N00000111 
                1100010  1 0101111111000111   
               1000 001    0001000011     
                11111 0101111101011101        
                10000010  100010100001        
                101111101011101111111         
                 11000001010100000101         
                  10101111101011111011       
                11010001010100010101         
                101110101010101010101         
                100000101010001010001         
                111111101011111011101         
                1101110101110101110111        
                  10100010000010001011       
                111011111111111010101         
                100010000000000010001         
                101010111011111111101         
                11111111111111111111
