SO src/north.xpm


NO                        src/north.xpm
  WE                  src/north.xpm
        
                EA          src/north.xpm
                   C       153,204,255           




F 164,169,123

1111
1N0
1111