SO src/north.xpm


NO                        src/north.xpm
                    src/north.xpm
        
                EA          src/north.xpm
                   C       153,204,255           




F 164,169,20

                11111111111111111111111111    
                11111111111111111111111111    
                111111111111111111111011111   
                1111   00000100000000011 
                1100010  1 010111111111     
               1000 001    0001000011     
                11111 0101111101011101        
                10000010  100010100001        
                101111101011101111111         
                 11000001010100000101         
                  101011N1101011111011       
                11010001010100010101         
                101110101010101010101         
                100000101010001010001
                111111111111111111111    
