NO textures/wood.xpm
SO textures/wood.xpm
WE textures/wood.xpm
EA textures/wood.xpm

F 164,169,20
C 153,204,255

1111111111111111111111111
10S0110000100000000000001
1000110000000000111111001
1000110000000000110001001
1000000000100000000001001
1111111111111111111111111

